s00w0000000w000
0w000w0ww0ww0w0
0w0ww000000wuw0
0w0000ww0w0www0
0ww0w00w00w0000
0w00ww0ww00wwww
0w0w000000w0000
0w0w0ww0w000ww0
0w00000000w00w0
0w0www0w0w0w000
0w0000000000w0w
0w0w0w0ww0w0000
0wd0000000w0rr0
0www0wwww0wwrgt
0000000000000tf
